0111110000000000000
0011111000000000000
0000011000000000000
0000000000000000000
0000000000000000000
0000000000000000000
0000000000011000000
0000000001111000000
0001111111111000000
0000111111111000000
0001111111110000000
0000000111100000000
0000000001100000000
0000000000000000000
0000000000000000000
0000000000000000000
0000000000001000000
0000000000011111000
0000000000000100000
0000000000000000000